grid = np.array([[0, 0, 0, 0, 0, 0, 0, 1, 0, 0],
                 [0, 1, 1, 0, 0, 0, 0, 1, 0, 0],
                 [0, 1, 1, 0, 0, 0, 0, 0, 0, 0],
                 [0, 1, 1, 0, 0, 0, 0, 0, 0, 0],
                 [0, 1, 1, 0, 0, 0, 0, 0, 0, 0],
                 [0, 1, 1, 0, 0, 0, 0, 0, 0, 0],
                 [0, 1, 1, 0, 0, 0, 0, 0, 0, 0],
                 [0, 1, 1, 0, 0, 0, 0, 0, 0, 0],
                 [0, 1, 1, 0, 0, 0, 0, 0, 0, 0],
                 [0, 0, 0, 0, 0, 0, 0, 0, 0, 0]])

grid = np.array([[0, 0, 1, 0, 0, 0, 0, 1, 0, 0],
                 [0, 1, 1, 0, 0, 0, 0, 1, 0, 0],
                 [0, 1, 1, 0, 0, 0, 0, 0, 0, 0],
                 [0, 1, 1, 0, 0, 0, 0, 0, 0, 0],
                 [0, 1, 1, 0, 0, 0, 0, 0, 0, 0],
                 [0, 1, 1, 0, 0, 0, 0, 0, 0, 0],
                 [0, 1, 1, 0, 0, 0, 0, 0, 0, 0],
                 [0, 1, 1, 0, 0, 0, 0, 0, 0, 0],
                 [0, 1, 1, 0, 0, 0, 0, 0, 0, 0],
                 [0, 0, 0, 0, 0, 0, 0, 0, 0, 0]])

grid = np.array([[0, 0, 1, 0, 0, 0, 0, 1, 0, 0],
                 [0, 1, 1, 0, 0, 0, 0, 1, 0, 0],
                 [0, 1, 1, 0, 0, 0, 0, 0, 0, 0],
                 [0, 0, 0, 0, 0, 1, 0, 0, 0, 0],
                 [0, 1, 1, 0, 0, 1, 0, 0, 0, 0],
                 [0, 1, 1, 0, 0, 1, 0, 0, 0, 0],
                 [0, 1, 1, 0, 0, 1, 0, 0, 0, 0],
                 [0, 1, 1, 0, 0, 0, 0, 0, 0, 0],
                 [0, 1, 1, 0, 0, 1, 0, 0, 0, 0],
                 [0, 0, 0, 0, 0, 1, 0, 0, 0, 0]])

grid = np.array([[0, 0, 0, 0, 1, 0, 0, 0, 0, 0],
                 [0, 1, 1, 0, 1, 0, 0, 0, 0, 0],
                 [0, 1, 1, 0, 1, 1, 0, 1, 0, 0],
                 [0, 1, 1, 0, 0, 0, 0, 1, 0, 0],
                 [0, 0, 1, 0, 0, 0, 1, 0, 0, 0],
                 [1, 0, 1, 0, 0, 0, 1, 0, 0, 0],
                 [1, 0, 1, 0, 1, 0, 1, 0, 0, 0],
                 [1, 0, 0, 0, 1, 0, 0, 0, 0, 0],
                 [0, 1, 1, 1, 1, 0, 0, 0, 0, 0],
                 [0, 0, 0, 0, 0, 0, 0, 0, 0, 0]])

grid = np.array([[0, 0, 1, 1, 1, 0, 0, 0, 0, 0],
                 [1, 0, 0, 0, 1, 0, 1, 0, 1, 0],
                 [0, 0, 1, 0, 0, 0, 1, 0, 1, 1],
                 [0, 1, 1, 1, 1, 1, 1, 0, 1, 0],
                 [0, 0, 0, 0, 0, 1, 0, 1, 1, 0],
                 [1, 1, 1, 1, 0, 1, 0, 0, 0, 0],
                 [0, 0, 0, 0, 0, 1, 0, 1, 1, 0],
                 [0, 1, 0, 1, 1, 1, 0, 0, 0, 0],
                 [0, 1, 0, 1, 1, 1, 1, 0, 1, 0],
                 [0, 1, 0, 0, 0, 0, 0, 0, 1, 0]])